 - - - - - - - - - - - - - - - - 
|     |             |           |
   -     - - - - -   -   - - - - 
| | | |     |       | |         |
       - -     - -       - - -   
| | |     | | |   | | | |       |
     - -                   - -   
| |       | | | | | | | |   | | |
     - - - -           -         
| | |         | | |       | | | |
       - - - - -   - - - -       
| | | | | |                 | | |
   -         - - - - - - - -     
|     | | |               |     |
 - -         - - -   - - -     - 
|     | | |     | |       | | | |
   - -       - - - - - - -       
|     | | |   | | |         | | |
   - -       - - - - - - - - -   
| |     | |                 |   |
   - -       - - - - - - - -     
|     |   | |         |       | |
 - -     -     -   - -   - - -   
|   | | |   | | | |     |       |
           -       - -     - -   
| |   | | |   | | |     | |   | |
 - -         -       - -         
|   | | | | |   | | |     | |   |
         -         -   - -       
| | |       | | |     |     | | |
     - - - -     - - - -     -   
| |           |           |   | |
 - - - - - - - - - - - - - - - -